000 000 000 000 000 000 000 000 000 000 000 000 000 000 000 000 000 000 000 000 000 000 000 018 000
018 000 000 000 070 000 071 110 111 112 113 114 071 018 000 000 130 131 132 000 000 104 000 000 000
000 000 088 000 000 000 072 115 116 117 118 119 072 000 000 133 134 135 136 137 000 105 000 000 018
000 000 089 000 000 000 071 120 121 122 123 124 071 000 000 138 139 140 141 142 000 106 000 000 000
001 001 001 001 012 000 072 125 126 127 128 129 072 070 000 143 144 145 146 147 000 000 076 000 000
000 088 000 000 013 001 012 000 011 001 001 001 001 001 001 001 012 000 000 000 018 000 077 000 000
000 089 018 000 000 000 015 000 013 012 073 000 000 000 073 011 014 000 000 087 000 000 000 018 000
000 000 092 000 018 000 015 000 000 015 074 000 000 000 074 015 000 018 000 000 000 070 000 000 018
018 000 093 107 000 000 015 000 000 015 075 078 079 080 075 015 000 000 000 000 000 000 000 000 000
000 000 000 108 000 000 013 001 001 006 073 081 082 083 073 006 001 001 001 001 012 000 018 087 000
076 000 000 109 000 000 092 000 088 015 074 084 085 086 074 015 000 000 000 000 013 001 001 001 001
077 000 000 087 000 000 093 000 089 015 075 000 000 000 075 015 070 018 000 000 000 000 018 000 000
096 095 095 095 095 095 095 095 097 013 006 006 001 001 001 014 000 000 000 107 000 076 000 000 000
094 090 090 090 090 090 090 090 094 000 011 014 087 000 000 000 018 000 018 108 000 077 000 101 000
094 090 090 090 090 090 090 090 094 000 015 000 000 000 104 000 000 000 070 109 000 000 000 102 018
094 090 090 090 090 090 090 090 094 000 013 012 000 000 105 000 000 018 000 000 000 018 000 103 000
094 090 090 090 090 090 090 090 094 000 000 015 000 000 106 000 071 000 110 111 112 113 114 000 071
094 090 090 090 090 090 090 090 094 088 000 015 087 000 000 000 072 000 115 116 117 118 119 000 072
094 090 090 090 090 090 090 090 094 089 000 015 000 000 070 000 071 000 120 121 122 123 124 000 071
098 095 095 095 095 095 095 095 099 000 000 015 000 000 000 000 072 000 125 126 127 128 129 000 072