00 17 00 00 00 17 00 17 00 00 34 21 21 32 16 00 00 22 00 27
00 00 17 00 17 00 00 00 00 00 00 00 16 34 21 32 16 22 16 27
00 17 00 00 00 15 16 00 00 17 00 00 00 00 00 34 21 33 00 30
16 00 00 00 16 13 01 04 00 00 00 00 00 00 00 00 00 00 00 02
04 00 00 00 00 16 16 15 00 00 00 16 15 00 00 00 00 02 01 06
09 04 16 00 00 00 00 10 01 03 03 01 14 16 00 00 00 15 16 10
16 13 01 12 00 17 00 00 16 07 05 16 00 00 17 00 02 08 00 00
00 00 00 15 16 00 00 00 02 09 06 04 00 00 00 16 15 00 00 00
00 00 00 13 01 01 03 03 08 16 10 06 04 00 00 02 05 00 17 00
00 00 17 00 00 00 10 05 00 00 16 07 09 01 01 06 05 00 00 00
32 00 00 00 00 17 00 10 04 00 02 08 16 00 00 10 08 00 17 00
34 32 00 17 00 00 00 00 10 03 08 17 00 00 17 00 00 00 00 00
00 22 00 00 00 00 00 00 00 15 00 00 00 17 00 00 17 00 00 00
16 22 00 00 17 00 00 00 00 15 00 00 00 00 00 00 00 00 00 00
16 34 32 00 00 00 00 00 16 15 16 00 00 00 17 00 00 00 17 00
00 16 34 32 00 00 00 00 02 06 04 00 00 00 00 00 00 00 00 00